######B#
# ###  #
#  ## ##
##     #
### ####
###A####
