#########B#
# ######  #
# #  ######
# #     ###
# ### ### #
#   # #   #
### # ### #
#   #   # #
### ##### #
A##########
    